Possible location exclusive moves:

https://www.reddit.com/r/pokemon/comments/5mvd3t/name_some_moves_you_want_certain_pokemon_to_gain/
Scizor - Glare and Crabhammer
Ampharos - DazzlinGleam
Kindgra - Flamethrower and Fire Blast

FOCUS_ENERGY: Eevee
LEER: Charmander
METRONOME: Elekid, Magby
MIST: Vaporeon
SLASH: Pinsir
STOMP: Tauros
DRAGON RAGE: Growlithe, Lapras, Aerodactyl
TRI ATTACK: Jigglypuff, Slowpoke, Drowzee, Chansey, Mewtwo
BATON_PASS [purified: Beedrill, Rapidash, Dodrio, Hypno, Zapdos, Natu]
CHARM [purified: Vulpix, Dugtrio, Golduck, Growlithe, Swinub, Houndour; Eevee, Wobuffet]
DRAGON_DANCE [Larvitar event move]
ENCORE [Dream World Psyduck]
HYPNOSIS [Dream World Zubat, Meowth]
LEECH_SEED [Dream World Tangela, Chikorita]
MIRROR_COAT [Dream World Girafarig, Mantine]
MIST [Dream World Poliwag]
PERISH_SONG [Dream World Cubone]

Gunk Shot: Meowth, Mankey, Mew, Teddiursa, Mantine, Phanpy
Heal Bell: Jynx, Lapras, Mew, Chinchou, Misdreavus, Snubbull
Low Kick: Golduck, Hitmonchan, Mewtwo, Mew, Typhlosion, Totodile, Snubbull, Sneasel, Ursaring, Tyranitar
Metronome: Mankey, Poliwhirl, Abra, Machop, Geodude, Gengar, Drowzee, Hitmonlee, Hitmonchan, Mr.Mime, Jynx, Mewtwo, Mew, Politoed, Snubbull, Teddiursa, Miltank
Pain Split: Jigglypuff, Porygon, Mew, Pineco, Dunsparce
Sky Attack: Doduo, Mew, Crobat, Togetic, Lugia
* Sucker Punch: NidoranM, Bellsprout, Geodude, Voltorb, Hitmonlee, Mew, Chinchou, Natu, Umbreon, Misdreavus, Girafarig, Corsola, Houndour, Hitmontop, Celebi
Super Fang: NidoranF, NidoranM, Mew, Snubbull
Twister: Charizard, Butterfree, Zubat, Venomoth, Articuno, Zapdos, Moltres, Mew, Togetic, Hitmontop
Nightmare: Butterfree, Clefairy, Jigglypuff, Meowth, Abra, Slowpoke, Lapras, Porygon, Mewtwo, Espeon, Umbreon, Misdreavus, Girafarig, Dunsparce, Sneasel, Houndour, Porygon2, Tyranitar, Lugia, Ho-Oh, Celebi

http://www.serebii.net/blackwhite/dreamworldattacks.shtml
